#^.^~****^*~~.~^~..~~~^~.^~.*~**.^^*^*^~..*^^..~^.
*#*~*.~^^^~~.*~*.**.~~^*^**.^~*^^.*^...^..^.**.~^*
^^#**~.*^*^..^**.~~~.~*.~^^~^~^.^~^*~**.~*^.^**.*.
*~~#~^.~*~^~^^*^**.~.*^^*~~^^*~.^.*^^*^.^.~~^^^*~.
*.^~#^.~^.^.^^*~^~~*^..^~^~~^.*^^..**.**~.~~^~*~**
^.^^~#.*~**.*~*^*~^*~~^.^.~.~^**~.^^^^*.~.~~~^^.^.
*~~.*#^~~~^*.^*~~~*^.^**^*^.^.^~~***^^*^.~^^.^^.~.
.~.*~~##.**.~^^~**^.^.^~~~^.~.^~~^^.~^^.^^~.~.~.*^
.^^^~~*~#^.~.*~.~~..~*~^.~**~..^****~.*~^~~*~**^~^
^^^*^^**.##*.^^*^^^.*~*~^^~*~~.~****~~~~***.^^~~^~
..*^^^^^.^~#^~.^.^~*~^*~**^*^.~~~*^.^^~**~*~..... 
**.^~~~^~*~#***.**^~.^.*^^^~.^...~.**^^^^~^.~^~.~*
^*~.*.~*^.~#^^^^^*~.**~^.*^*.~~..^~~~*~*^.~~^*^*^^
~*^.^..**~**#*^~***^~~*^*.*~..~^^***^.*~.^*^^^^.~.
*~^~^**^^*^^~#*~^^*~~~*^*~~~~*~^^^*~..~~~~~.*~^~*.
^.*.^*^**^^^~*#.*.~^~~~^..~~~*~~^*~..^^.^~*.^~^~**
.***^..*^~~~~^~#*^~~.*.~^.^^*.***^~^.*....~.^.*~^^
^^~~~~.**.*.^^*#^~~^....*~*^~*^^.^~~~^*.~^^^~**^~~
^~~*^*.~.*^^^*^.##.~*...~**^.^^~.^^.^..^.^**.^^..*
~^***~^.~.~^^^*~~~#*..^~^^.~^.~.**...~^~**~^~~**^~
~~~^~.^*.^*.~*.*~~^#.~*^^~~**.*.*.~^^^..^.~^.*.^~~
^^~...^.*~.^^**~^~*.#^~^~*....^.^^**~.*.^^*..~*~.*
^..^...~.~.*.~***~*~~#..~*~^^~~^~**^~~^*^^~*.~*^*^
*^.**^~*****.~~~..~^~#*.^*~^.^^*^..*~^.^.^*.^.~^^*
~...~*^....*^.*^^*...^#~~..^.*~.*~.*^.^*^*^.****^~
^..~***^.*^~~.****.~*^#~.^~*.~^*^~^.****~..~*..*^~
.~^~**~^^..~~~^..*~*.^*#~..^^*.~.*..*~~*~.^~.~*~~.
.***~..~**^.~.~.~*.~~**.#^.^~..~*~~~~*.**~~^..^.^^
~.*.~^*^*~^.~*..*~^~~.*.*#.*.*..^~.*~^^*.~^.^~^**^
.*^~^^*.^*.~*...*~~~*.**.~###*.*^.^*.^*~*.^~^**^*.
.~..*....~..~.***~..~^..~~^*^#^~^^~~**^.*~**^**^^*
^.*.~.^.**^*^.~^^*.~..*^~*^***#~**..^.~~*..^*^~*.~
^~~^~~*.~^^~~^**.^.^^^*^.*^^~~#^##~^*^^..**..**..^
^.^*.*^..*.~~.^^***^.*~..~.**^*#~^####^~*.~^~^..~~
~^^.^..*^^.**.~~^*~*^~*~^~~.~*.^~.~*^~#.*..^.^^*^*
^^.~*^~~*.~~*~.^..~*.^.~**.^*^.^~.**.~*#~...~~..*.
.~..^.~.~.^*.~^*~.~.*^*~~*.^.******~*~~#^~~~^.~~*~
~.*..^^*^~*.~~.~.^~..~.~^^^.*~*.**~^*~*^#^^~..^~^^
*.^*^**^*.^^*....**..~^^~.^*^.*~*^**^^..*##^*^^^.~
^*^~^^*.~*~^*~^~~.*.^*^~*^^~.*~.*~.**.*~^~~#~#^~~*
~~**~*.^.*~..~~^^^~^^^.~***^*.^*~^*~^~*~**..#~##~.
*~**^~~.^.*.~^**~*^^.*^*.^~~*~~~*^.*..~~^*^.*^.^#*
.*^~..*~.*^^^^^~~^^*.~*.~~~.***~^.*..~~******~~^*#
.^^..^.^*^~^.~*...**~~~.**^*~~~*^***~^*^~^~~^^^*#*
**.**~.**~.*.*^~~.~^.*^.~~*.^*.~.***~*^^..~*.~*#*^
~..^.****^.****~^~***..^^^^*^.~*^^*.~~.^**^*~^*#~~
^*~^.~*...^^.^~.^^..~^...**...^****^*~*~*^..~^*~#~
...^~^.~^^~~~~.*^~.^~***~~^^^.*^^.~.^*~*~**^***^~#
.~~~~~^^.~~*^.~^^^**~^~.^~^~*..^*~^^*..*~^~**.*.^#
~^**.~**..*^~^^^.^*^~^~*^.~*~.^.**.^.^^.~**^~~^~^#
                                                  
